11111111111111111111
10000000000000002001
10111111111111111101
10100000000000000101
10101110000001110101
10101010000001010101
10101110000001110101
10100000010000000101
10100000010000000101
10100000010000000101
10100000000000000101
10100000000000000101
10101110000011110101
10100001000100000101
10100000111000000101
10100000000000000101
10100000000000000101
10111111111111111101
10000000000000000031
11111111111111111111